                                                                                                                                                                                                                                                                                  Turkey Street
                                                                                                                                                                                                                                                                       by Raymond Vermeulen and Matthew Deline

Welcome to Turkey Street! You are about to embark upon a gritty and super serious parser adventure where you play as a turkey detective. Before you start, please be aware that some of the commands may be different from other games that you have played in the past.

Commands are limited to directional travel (N, S, E, W), LOOK, EXAMINE (or X), TAKE, DROP, WAIT, and GOBBLE or GOBBLE AT (which refers to turkey speak, not the action of eating). If you are unfamiliar with parser based games, you can type HELP or COMMANDS to get a full list, and SAVE to save your progress. Have fun!

   Start the story - from the beginning    :    (SPACE)
                   - from a saved position :       R
   Quit                                    :       Q

>exit
But you aren't in anything at the moment.

* * *

>look
Roost
The roost smells faintly of sawdust, old eggs, and bourbon. The half-drunk bottle explains the half-drunk turkey. A chick is pacing back and forth, occasionally stopping to peck at itself.

* * *

>n
On the Case
DESCRIPTION

>n
Turkey Street Station
DESCRIPTION

>w
Turkey Street West
DESCRIPTION WEST

>e
Turkey Street Station
DESCRIPTION

>w
Turkey Street West
DESCRIPTION WEST

* * *

>n
On the Case
DESCRIPTION

>s
Roost

>n
On the Case

* * *

>save
Save failed.

* * *

>w
You can't go that way.

* * *

>x
What do you want to examine?

>w
You see nothing unexpected in that direction.