                                                                                                                                                                                                                                                                            Turkey Street
                                                                                                                                                                                                                                                                 by Raymond Vermeulen and Matthew Deline

  

Welcome to Turkey Street! You are about to embark upon a gritty and super serious parser adventure where you play as a turkey detective. Before you start, please be aware that some of the commands may be different from other games that you have played in the past. Examine all of the evidence to solve the case!

Commands are limited to directional travel (N, S, E, W), LOOK, EXAMINE (or X), GIVE, TAKE, DROP, WAIT, EAT, DRINK, and GOBBLE or GOBBLE AT (which refers to turkey speak, not the action of eating). You can also type COMMANDS to see this list again, UNDO to go back a turn, or SAVE to record your progress. Have fun!

   Start the story - from the beginning    :    (SPACE)
                   - from a saved position :       R
   Quit                                    :       Q

Turkey Street
An Interactive Fiction by Raymond Vermeulen and Matthew Deline
Release 1 / Serial number 180502 / Inform 7 build 6M62 (I6/v6.33 lib 6/12N) SD

The Roost
Back at the roost, there's two wild turkeys. One's a bottle and it's perfectly aged, one's a P.I. and it's aged perfectly. The name's Fowl Feathers. Uncompromising since 2015. In my line of work, you meet a lot of birds. And the birds always like a bad egg. 

The roost smells faintly of sawdust, old eggs, and bourbon. The half-drunk bottle explains the half-drunk turkey. A chick is pacing back and forth, occasionally stopping to peck at itself.

You can see a sign here.

>n
On the Case
The chick's distress is still fresh and palpable. She can't help me now. I leave her to her clucking. With some luck, she'll still be there when I come home to roost. I spread my wings and glide away to the next case. A case more interesting than the typical cuckolding of henpecked husbands I get saddled with. The case of... WHY THE CHICKEN CROSSED THE ROAD.

>restart
Are you sure you want to restart?

>y
Turkey Street
                                                                        by Raymond Vermeulen and Matthew Deline

Welcome to Turkey Street! You are about to embark upon a gritty and super serious parser adventure where you play as a turkey detective. Before you start, please be aware that some of the commands may be different from other games that you have played in the past.

Commands are limited to directional travel (N, S, E, W), LOOK, EXAMINE (or X), GIVE, TAKE, DROP, WAIT, EAT, DRINK, and GOBBLE or GOBBLE AT (which refers to turkey speak, not the action of eating). You can also type COMMANDS to see this list again, UNDO to go back a turn, or SAVE to record your progress. Have fun!

   Start the story - from the beginning    :    (SPACE)
                   - from a saved position :       R
   Quit                                    :       Q

* * *

>cheat
In my line of work, you meet a lot of birds. And the birds always like a bad egg. But the bad eggs... don't always like the birds. 

 The rose, the picture, the locket, the book, the ring... they tell a story of a chicken consumed with love. But the letter... the letter tells the story of a forbidden love. Love that cannot, should not be. 

 It wasn't the car that killed the chicken. It wasn't the tire pressing down on the spine, it wasn't the sudden egress of organs. It was the simplest thing in the world. 

 The chicken was killed with love. Love drove it out into the street, love drove it out to find an ending. 

 Why did the chicken cross Turkey Street? Why did the chicken cross the road? We all know this one. The chicken crossed the road... to get to the other side. 

    *** The End ***

In that game you scored 1000 out of a possible 70, in 1 turn.

Would you like to RESTART, RESTORE a saved game, QUIT or UNDO the last command?

* * *

>close door
You can't do that! You're a turkey!

>open door
You can't do that! You're a turkey!

* * *

>close door
You can't do that! You're a turkey!

>speak
I didn't understand that sentence.

>talk
That's not a verb I recognise.

>talk to
That's not a verb I recognise.

>verds
That's not a verb I recognise.

>verbs
That's not a verb I recognise.

>LIST
That's not a verb I recognise.

>SHOWME
The Roost - room
    yourself - person
    exit door - closed door

>COMMAND
That's not a verb I recognise.

>COMMANDS
That's not a verb I recognise.

>RULES
Rules tracing now switched on. Type "rules off" to switch it off again, or "rules all" to include even rules which do not apply.

>RULES
[Rule "declare everything initially unmentioned rule" applies.]
Rules tracing now switched on. Type "rules off" to switch it off again, or "rules all" to include even rules which do not apply.

>take
(the exit door)
[Rule "declare everything initially unmentioned rule" applies.]
[Rule "announce items from multiple object lists rule" applies.]
[Rule "set pronouns from items from multiple object lists rule" applies.]
[Rule "before stage rule" applies.]
[Rule "instead stage rule" applies.]
[Rule "investigate player's awareness before action rule" applies.]
[Rule "player aware of his own actions rule" applies.]
[Rule "check stage rule" applies.]
[Rule "can't take yourself rule" applies.]
[Rule "can't take other people rule" applies.]
[Rule "can't take component parts rule" applies.]
[Rule "can't take people's possessions rule" applies.]
[Rule "can't take items out of play rule" applies.]
[Rule "can't take what you're inside rule" applies.]
[Rule "can't take what's already taken rule" applies.]
[Rule "can't take scenery rule" applies.]
[Rule "can only take things rule" applies.]
[Rule "can't take what's fixed in place rule" applies.]
That's fixed in place.

[Rule "A first turn sequence rule" applies.]
[Rule "every turn stage rule" applies.]
[Rule "A last turn sequence rule" applies.]
[Rule "notify score changes rule" applies.]

* * *

>drink bottle
You have had enough

* * *

>exit
But you aren't in anything at the moment.

>quit
Are you sure you want to quit?

* * *

>gobble
What do you want to gobble?

>gobbble
You can't see any such thing.

* * *

>gobble
What do you want to gobble?

>gobble at
What do you want to gobble at?

* * *

>gobble
What do you want to gobble?

>gobble chick
"Gobble gobble?" Cluck. Cluck. Cluck cluck CLUCK-AH." She sings her sweet song to me.

>gobble bottle
GOBBLE GOBBLE GOBBLE!

* * *

>gobble at chick
"Cluck. Cluck. Cluck cluck CLUCK-AH." She sings her sweet song to me.

>n
On the Case
You are on the case! Keep heading north to reach Turkey Street

>n
Turkey Street Station
DESCRIPTION

A very dead chicken lies in the center of the road

You can also see a fox and an Eagle here.

>w
Turkey Street West
DESCRIPTION WEST

You can see a Duck and a Heron here.

>e
Turkey Street Station
DESCRIPTION

A very dead chicken lies in the center of the road

You can also see a fox and an Eagle here.

>e
Turkey Street East
DESCRIPTION EAST

You can see a child and an Owl here.

* * *

>gobble at child
GOBBLE GOBBLE GOBBLE!
The child runs screaming

* * *

>gobble book
I didn't understand that sentence.

* * *

>gobble bottle
OH FUCK!

>n
On the Case
The chick's distress is still fresh and palpable. She can't help me now. I leave her to her clucking. With some luck, she'll still be there when I come home to roost. I spread my wings and glide away to the next case. A case more interesting than the typical cuckolding of henpecked husbands I get saddled with. The case of... WHY THE CHICKEN CROSSED THE ROAD.

>n
Turkey Street Station
A bang. A yelp. A corpse. A chicken with a chalk outline, leaving behind a ghost with nobody to haunt.  The pancaked poultry beckons from within the cordon. I'll have to do the haunting for it. 

All roads lead back to the scene of the crime. Futility, or just fatality? There's a metaphor here, if one cares to explore it. And also a station entrance. A lonely lamppost stands across the street, like a lighthouse for a shipwrecked life.

A very dead chicken lies in the center of the road

Crows. Scavengers, the murderous lot of them. I'd watch my belongings around them, if I could carry any.

Glorious, majestic, and free in all the ways that I am not. I already hate this bird. The feeling is probably mutual.

>w
Turkey Street West
A cardinal direction. A cardinal sin. My corpse has taken another spin on the karmic wheel, helped along by some mundane ones. There's no justice on these streets. There's just us. 

The West End is known for two things. Good plays, and bad turns. Which explains the unfolding supermarket turf war. The cordon of turkeys is a recent addition.

Herons like to feast on small prey. This one has a lean, hungry look to it. It knows something.

A winged killer, a seductive bird of prey. Once its yellow eye falls on you, it's already too late. Did it fall on the chicken?

You can also see a bus stop and a garbage bin here.

* * *

>x chick
You see nothing special about the chick.

* * *

>gobble child
GOBBLE GOBBLE GOBBLE!
The child runs screaming, and appears to have dropped something

>look
The Roost
The roost smells faintly of sawdust, old eggs, and bourbon. The half-drunk bottle explains the half-drunk turkey. A chick is pacing back and forth, occasionally stopping to peck at itself.

You can see a book here.

>x book
You see nothing special about the book.

    *** The End ***

In that game you scored 50 out of a possible 50, in 3 turns.

Would you like to RESTART, RESTORE a saved game, QUIT or UNDO the last command?

>x book
You see nothing special about the book.

* * *

>gobble child
GOBBLE GOBBLE GOBBLE!
The child runs screaming, and appears to have dropped something

>s
You can't go that way.

>s
You can't go that way.

>n
On the Case
You are on the case! Keep heading north to reach Turkey Street

>n
Turkey Street Station
DESCRIPTION

A very dead chicken lies in the center of the road

>s
(first opening Station Entrance)
You can't do that! You're a turkey!

* * *

>gobble child
GOBBLE GOBBLE GOBBLE!
The child runs screaming, and appears to have dropped something

>w
You can't go that way.

>w
You can't go that way.

>z
Time passes.

>z
Time passes.

>look
The Roost
The roost smells faintly of sawdust, old eggs, and bourbon. The half-drunk bottle explains the half-drunk turkey. A chick is pacing back and forth, occasionally stopping to peck at itself.

You can see a book here.

>z
Time passes.

* * *

>i
You are carrying nothing.

* * *

>look
Roost
The roost smells faintly of sawdust, old eggs, and bourbon. The half-drunk bottle explains the half-drunk turkey. A chick is pacing back and forth, occasionally stopping to peck at itself.

>x
What do you want to examine?

>look at chick
You can't see any such thing.

>x chick
You can't see any such thing.

* * *

>look
Roost
The roost smells faintly of sawdust, old eggs, and bourbon. The half-drunk bottle explains the half-drunk turkey. A chick is pacing back and forth, occasionally stopping to peck at itself.

>x door
You can't see any such thing.

>x blue door
You can't see any such thing.

>open blue door
You can't see any such thing.

>n
blue door

>open door
You can't see any such thing.

* * *

>n
On the Case
The chick's distress is still fresh and palpable. She can't help me now. I leave her to her clucking. With some luck, she'll still be there when I come home to roost. I spread my wings and glide away to the next case. A case more interesting than the typical cuckolding of henpecked husbands I get saddled with. The case of... WHY THE CHICKEN CROSSED THE ROAD. 

This road continues north ... to Turkey Street.

>n
Turkey Street Station
A bang. A yelp. A corpse. A chicken with a chalk outline, leaving behind a ghost with nobody to haunt.  The pancaked poultry beckons from within the cordon. I'll have to do the haunting for it. 

All roads lead back to the scene of the crime. Futility, or just fatality? There's a metaphor here, if one cares to explore it. And also a station entrance. A lonely lamppost stands across the street near a Nando's, like a lighthouse for a shipwrecked life.

You can see a dead chicken, a cardboard box with a hole in it, a crow and an Eagle here.

>x crow
Upon closer examination, the crow appears to have a locket hanging from it's neck. Maybe you could scare the crow into dropping it somehow

>gobble crow
You stare down the crow. It stares back at you. Time slows down. Eternity passes. "Gobble. GOBBLE." 

 "Ca-kaw! Ca'kaw caKAW" The crow screeches and drops the locket just out of reach. You should take it to examine it elsewhere before it snatches it back!

Your standoff with the crow has terrified the mouse. It no longer feels safe inside it's cardboard box and is escaping for freedom with the shiny thing. Catch it!

*** Run-time problem P10: Since the field mouse is not allowed the property "evidence condition", it is against the rules to try to use it.

* * *

>n
On the Case
The chick's distress is still fresh and palpable. She can't help me now. I leave her to her clucking. With some luck, she'll still be there when I come home to roost. I spread my wings and glide away to the next case. A case more interesting than the typical cuckolding of henpecked husbands I get saddled with. The case of... WHY THE CHICKEN CROSSED THE ROAD. 

This road continues north ... to Turkey Street.

>e
You can't go home again. You are ON. THE. CASE.

>s
You can't go home again. You are ON. THE. CASE.

* * *

>n
On the Case
The chick's distress is still fresh and palpable. She can't help me now. I leave her to her clucking. With some luck, she'll still be there when I come home to roost. I spread my wings and glide away to the next case. A case more interesting than the typical cuckolding of henpecked husbands I get saddled with. The case of... WHY THE CHICKEN CROSSED THE ROAD. 

This road continues north ... to Turkey Street.

>m
That's not a verb I recognise.

>n
Turkey Street Station
A bang. A yelp. A corpse. A chicken with a chalk outline, leaving behind a ghost with nobody to haunt.  The pancaked poultry beckons from within the cordon. I'll have to do the haunting for it. 

All roads lead back to the scene of the crime. Futility, or just fatality? There's a metaphor here, if one cares to explore it. And also a station entrance. A lonely lamppost stands across the street near a Nando's, like a lighthouse for a shipwrecked life.

You can see a dead chicken, a cardboard box with a hole in it, a crow and an Eagle here.

>e
Turkey Street East
People have always looked to the East for their panaceas. But Turkey Street is sick, rotten to the core. I can't cure what ails it--I can only burn it out. 

There's an edge to the air in East End, an edge I live on. And so does an ornithophobic child cowering in fear from the spectre of a gluttonous duck feasting on bits of bread strewn everywhere. For now, a cordon of turkeys joins me on the edge.

You can see a child and a duck here.

>take bread
YAY
Taken.

>take bread
Alas, you are a turkey and have nowhere else to carry things. Please drop what you have before picking this up

>x bread
You see nothing special about the bits of bread.

>eat bread
You eat the bits of bread. Not bad.

>x bread
You can't see any such thing.

* * *

>n
Turkey Street Station
A bang. A yelp. A corpse. A chicken with a chalk outline, leaving behind a ghost with nobody to haunt.  The pancaked poultry beckons from within the cordon. I'll have to do the haunting for it. 

All roads lead back to the scene of the crime. Futility, or just fatality? There's a metaphor here, if one cares to explore it. And also a station entrance. A lonely lamppost stands across the street near a Nando's, like a lighthouse for a shipwrecked life.

You can see a dead chicken, a cardboard box with a hole in it, a crow and an Eagle here.

>e
Turkey Street East
People have always looked to the East for their panaceas. But Turkey Street is sick, rotten to the core. I can't cure what ails it--I can only burn it out. 

There's an edge to the air in East End, an edge I live on.  And so does an ornithophobic child cowering in fear from the spectre of a gluttonous duck feasting on bread strewn everywhere. For now, a cordon of turkeys joins me on the edge to the east.

You can see some bread, a child and a duck here.

>e
The road is blocked by Turkeys!

>e
The road is blocked by Turkeys!

>w
Turkey Street Station
All roads lead back to the scene of the crime. Futility, or just fatality? There's a metaphor here, if one cares to explore it. And also a station entrance. A lonely lamppost stands across the street, like a lighthouse for a shipwrecked life.

A very dead chicken lies in the center of the road

Crows. Scavengers, the murderous lot of them. I'd watch my belongings around them, if I could carry any.

Glorious, majestic, and free in all the ways that I am not. I already hate this bird. The feeling is probably mutual.

>w
Turkey Street West
A cardinal direction. A cardinal sin. My corpse has taken another spin on the karmic wheel, helped along by some mundane ones. There's no justice on these streets. There's just us. 

The West End is known for two things. Good plays, and bad turns. Which explains the unfolding supermarket turf war. The cordon of turkeys is a recent addition.

Herons like to feast on small prey. This one has a lean, hungry look to it. It knows something.

A winged killer, a seductive bird of prey. Once its yellow eye falls on you, it's already too late. Did it fall on the chicken?

You can also see a bus stop and a garbage bin here.

>w
The road is blocked by Turkeys!

* * *

>e
The road is blocked by Turkeys!

>gobble child
GOBBLE GOBBLE GOBBLE!
The child runs screaming, and appears to have dropped something
GOBBLE GOBBLE GOBBLE!

>look
Turkey Street East
There's an edge to the air in East End, an edge I live on. 

You can see a book, some bread and a duck here.

* * *

>e
The road is blocked by Turkeys!

>x child
A small human with its back turned to you. Like all of its kind, the child delights in violence, and is acquainted with fear. Good.

>x child
A small human with its back turned to you. Like all of its kind, the child delights in violence, and is acquainted with fear. Good.

* * *

>e
Turkey Street East
People have always looked to the East for their panaceas. But Turkey Street is sick, rotten to the core. I can't cure what ails it--I can only burn it out. 

There's an edge to the air in East End, an edge I live on.  And so does an ornithophobic child cowering in fear from the spectre of a gluttonous duck feasting on bread strewn everywhere. For now, a cordon of turkeys joins me on the edge to the east.

You can see some bread, a child and a duck here.

>eat bread
(first taking the bread)
YAY
You eat the bread. Not bad.

>look
Turkey Street East
There's an edge to the air in East End, an edge I live on.  And so does an ornithophobic child cowering in fear from the spectre of a gluttonous duck feasting on bread strewn everywhere. For now, a cordon of turkeys joins me on the edge.

You can see a child and a duck here.

>x bread
You can't see any such thing.

* * *

>e
Turkey Street East
People have always looked to the East for their panaceas. But Turkey Street is sick, rotten to the core. I can't cure what ails it--I can only burn it out. 

There's an edge to the air in East End, an edge I live on.  And so does an ornithophobic child cowering in fear from the spectre of a gluttonous duck feasting on bread strewn everywhere. For now, a cordon of turkeys joins me on the edge to the east.

You can see some bread, a child and a duck here.

>gobble child
GOBBLE GOBBLE GOBBLE!
The child runs screaming, and appears to have dropped something

>look
Turkey Street East
There's an edge to the air in East End, an edge I live on. And so does a gluttonous duck feasting on bread strewn everywhere. For now, a cordon of turkeys joins me on the edge to the east.

You can see a book, some bread and a duck here.

>x book
"A Night Time Smoke". Trashy and romantic. Like my life.

[Your score has just gone up by ten points.]

>look
Turkey Street East
There's an edge to the air in East End, an edge I live on. And so does a gluttonous duck feasting on bread strewn everywhere. For now, a cordon of turkeys joins me on the edge to the east.

You can see a book (examined), some bread and a duck here.

>eat bread
"QUACK QUACK QU-AAAAACK!" The duck shouts at you furiously for finishing it's meal. It might as well be spitting! Digging into its feathers it tosses something red in your general direction.

>look
Turkey Street East
There's an edge to the air in East End, an edge I live on.  And so does an irate duck.For now, a cordon of turkeys joins me on the edge to the east.

You can see a rose, a book and a duck here.

>x rose
The symbolism of a rose is obvious: "My love for you is transitory and based solely on your appearance".

[Your score has just gone up by ten points.]

>w
Turkey Street Station
All roads lead back to the scene of the crime. Futility, or just fatality? There's a metaphor here, if one cares to explore it. And also a station entrance. A lonely lamppost stands across the street near a Nando's, like a lighthouse for a shipwrecked life.

You can see a dead chicken, a cardboard box with a hole in it, a crow and an Eagle here.

>x chicken
This chicken is quite dead. Tire-tracks run down its spine and through its spilled guts. Still clutched in its beak, a letter!

>look
Turkey Street Station
All roads lead back to the scene of the crime. Futility, or just fatality? There's a metaphor here, if one cares to explore it. And also a station entrance. A lonely lamppost stands across the street near a Nando's, like a lighthouse for a shipwrecked life.

You can see a letter, a dead chicken, a cardboard box with a hole in it, a crow and an Eagle here.

>x letter
Is this... an ode to farts? Whatever it is, it's personal, sappy, and somewhat disgusting.

[Your score has just gone up by ten points.]

>x crow
Upon closer examination, the crow appears to have a locket hanging from it's neck. Maybe you could scare the crow into dropping it somehow

>gobble crow
You stare down the crow. It stares back at you. Time slows down. Eternity passes. "Gobble. GOBBLE." 

 "Ca-kaw! Ca'kaw caKAW" The crow screeches and drops the locket just out of reach. You should take it to examine it elsewhere before it snatches it back!

Your standoff with the crow has terrified the mouse. It no longer feels safe inside it's cardboard box and is escaping for freedom with the shiny thing. Catch it!

Death swoops in from above and in a flash of beak and squeak, the mouse is gone. The eagle returns to his perch, leaving the shiny ring on the ground.

>look
Turkey Street Station
All roads lead back to the scene of the crime. Futility, or just fatality? There's a metaphor here, if one cares to explore it. And also a station entrance. A lonely lamppost stands across the street near a Nando's, like a lighthouse for a shipwrecked life.

You can see a ring, a locket, a letter, a dead chicken, a cardboard box with a hole in it, a crow and an Eagle here.

>x ring
A small, shiny bauble. A white elephant.

[Your score has just gone up by ten points.]

>x locket
A small, heart-shaped locket. No inscription. Just a chicken... and a chick.

[Your score has just gone up by ten points.]

>score
You have so far scored 50 out of a possible 70, in 20 turns.

>w
Turkey Street West
A cardinal direction. A cardinal sin. My corpse has taken another spin on the karmic wheel, helped along by some mundane ones. There's no justice on these streets. There's just us. 

The West End is known for two things. Good plays, and bad turns. Which explains the unfolding supermarket turf war. The cordon of turkeys to the west is a recent addition.

You can see a bus stop, a garbage bin, a heron and an Owl here.

>x bin
This garbage bin is utterly filthy, like your sense of humor. In the depths of this filth (within the bin, not yourself) lies ... THE MURDER WEAPON.

>x murder weapon
It is such a simple thing. Small, yet incalculably valuable. And to the right bird, lethal.

[Your score has just gone up by ten points.]

>get up bus stop
I only understood you as far as wanting to get up.

>up
You get onto the bus stop.

On the bus stop you can see a red herring.

>take herring
Taken.

Drooling, the heron eyes you closely with an intense stare. Are these the eyes of a chicken chaser, or of hunger?

>down
You get off the bus stop.

Turkey Street West
The West End is known for two things. Good plays, and bad turns. Which explains the unfolding supermarket turf war. The cordon of turkeys to the west is a recent addition.

You can see a bus stop, a garbage bin, a heron and an Owl here.

Drooling, the heron eyes you closely with an intense stare. Are these the eyes of a chicken chaser, or of hunger?

>give heron the herring
The heron snaps the herring from your beak hungrily. In the commotion, it drops a torn photograph

>x photograph
A picture of two near-identical chicks. Crudely torn apart by life's currents.

In my line of work, you meet a lot of birds. And the birds always like a bad egg. But the bad eggs... don't always like the birds. 

 The rose, the picture, the locket, the book, the ring... they tell a story of a chicken consumed with love. But the letter... the letter tells the story of a forbidden love. Love that cannot, should not be. 

 It wasn't the car that killed the chicken. It wasn't the tire pressing down on the spine, it wasn't the sudden egress of organs. It was the simplest thing in the world. 

 The chicken was killed with love. Love drove it out into the street, love drove it out to find an ending. 

 Why did the chicken cross Turkey Street? Why did the chicken cross the road? We all know this one. The chicken crossed the road... to get to the other side. 

    *** The End ***

In that game you scored 70 out of a possible 70, in 27 turns.

Would you like to RESTART, RESTORE a saved game, QUIT or UNDO the last command?

* * *

>e
Turkey Street East
People have always looked to the East for their panaceas. But Turkey Street is sick, rotten to the core. I can't cure what ails it--I can only burn it out. 

There's an edge to the air in East End, an edge I live on.  And so does an ornithophobic child cowering in fear from the spectre of a gluttonous duck feasting on bread strewn everywhere. For now, a cordon of turkeys joins me on the edge to the east.

You can see some bread, a child and a duck here.

>take bread
NAY

>eat bread
You eat the bits of bread. Not bad.

>look
Turkey Street East
There's an edge to the air in East End, an edge I live on. And so does an ornithophobic child cowering in fear from the spectre of a gluttonous duck feasting on bits of bread strewn everywhere. For now, a cordon of turkeys joins me on the edge.

You can see a child and a duck here.

>x bread
You can't see any such thing.

* * *

>take bread
NAY

>i
You are carrying:
  some bits of bread

* * *

>take bread
NAY

>look
Turkey Street East
There's an edge to the air in East End, an edge I live on. And so does an ornithophobic child cowering in fear from the spectre of an irate duck. For now, a cordon of turkeys joins me on the edge to the east.

You can see a rose, a child and a duck here.

* * *

>e
Turkey Street East
People have always looked to the East for their panaceas. But Turkey Street is sick, rotten to the core. I can't cure what ails it--I can only burn it out. 

There's an edge to the air in East End, an edge I live on.  And so does an ornithophobic child cowering in fear from the spectre of a gluttonous duck feasting on bread strewn everywhere. For now, a cordon of turkeys joins me on the edge to the east.

You can see some bread, a child and a duck here.

>x bread
You see nothing special about the bits of bread.

>eat bread
They're plainly inedible.

>take bread
They're plainly inedible.

* * *

>n
Turkey Street Station
A bang. A yelp. A corpse. A chicken with a chalk outline, leaving behind a ghost with nobody to haunt.  The pancaked poultry beckons from within the cordon. I'll have to do the haunting for it. 

All roads lead back to the scene of the crime. Futility, or just fatality? There's a metaphor here, if one cares to explore it. And also a station entrance. A lonely lamppost stands across the street near a Nando's, like a lighthouse for a shipwrecked life.

You can see a dead chicken, a cardboard box with a hole in it, a crow and an Eagle here.

>gobble at
What do you want to gobble at?

>gobble at
What do you want to gobble at?

>gobble at bin
You can't see any such thing.

>w
Turkey Street West
A cardinal direction. A cardinal sin. My corpse has taken another spin on the karmic wheel, helped along by some mundane ones. There's no justice on these streets. There's just us. 

The West End is known for two things. Good plays, and bad turns. Which explains the unfolding supermarket turf war. The cordon of turkeys is a recent addition.

Herons like to feast on small prey. This one has a lean, hungry look to it. It knows something.

A winged killer, a seductive bird of prey. Once its yellow eye falls on you, it's already too late. Did it fall on the chicken?

You can also see a bus stop and a garbage bin here.

* * *

>n
Turkey Street Station
A bang. A yelp. A corpse. A chicken with a chalk outline, leaving behind a ghost with nobody to haunt.  The pancaked poultry beckons from within the cordon. I'll have to do the haunting for it. 

All roads lead back to the scene of the crime. Futility, or just fatality? There's a metaphor here, if one cares to explore it. And also a station entrance. A lonely lamppost stands across the street near a Nando's, like a lighthouse for a shipwrecked life.

You can see a dead chicken, a cardboard box with a hole in it, a crow and an Eagle here.

>gobble crow
"Gobble, gobble." "Ca-kaw! Ca'kaw caKAW" Chattering away like a thief in the night.

>look
Turkey Street Station
All roads lead back to the scene of the crime. Futility, or just fatality? There's a metaphor here, if one cares to explore it. And also a station entrance. A lonely lamppost stands across the street near a Nando's, like a lighthouse for a shipwrecked life.

You can see a dead chicken, a cardboard box with a hole in it, a crow and an Eagle here.

* * *

>gobble crow
"Gobble, gobble." "Ca-kaw! Ca'kaw caKAW" Chattering away like a thief in the night.

>z
Time passes.

>look
Turkey Street Station
All roads lead back to the scene of the crime. Futility, or just fatality? There's a metaphor here, if one cares to explore it. And also a station entrance. A lonely lamppost stands across the street near a Nando's, like a lighthouse for a shipwrecked life.

You can see a dead chicken, a cardboard box with a hole in it, a crow and an Eagle here.

>x crow
Upon closer examination, the crow appears to have a locket hanging from it's neck. Maybe you could scare the crow into dropping it somehow

* * *

>n
Turkey Street Station
A bang. A yelp. A corpse. A chicken with a chalk outline, leaving behind a ghost with nobody to haunt.  The pancaked poultry beckons from within the cordon. I'll have to do the haunting for it. 

All roads lead back to the scene of the crime. Futility, or just fatality? There's a metaphor here, if one cares to explore it. And also a station entrance. A lonely lamppost stands across the street near a Nando's, like a lighthouse for a shipwrecked life.

You can see a dead chicken, a cardboard box with a hole in it, a crow and an Eagle here.

>look
Turkey Street Station
DESCRIPTION

>look around
You can't see any such thing.

>look
Turkey Street Station
DESCRIPTION

>examine
(Station Entrance)
You see nothing special about Station Entrance.

* * *

>look
Turkey Street Station
DESCRIPTION

>s
(first opening Station Entrance)
You can't do that! You're a turkey!

>w
Turkey Street West
DESCRIPTION WEST

>n
(first opening Sainsburys Entrance door)
You can't do that! You're a turkey!

>rules
Rules tracing now switched on. Type "rules off" to switch it off again, or "rules all" to include even rules which do not apply.

>n
[Rule "declare everything initially unmentioned rule" applies.]
[Rule "standard set going variables rule" applies.]
[Rule "announce items from multiple object lists rule" applies.]
[Rule "set pronouns from items from multiple object lists rule" applies.]
[Rule "before stage rule" applies.]
[Rule "instead stage rule" applies.]
[Rule "investigate player's awareness before action rule" applies.]
[Rule "player aware of his own actions rule" applies.]
[Rule "check stage rule" applies.]
[Rule "can't travel in what's not a vehicle rule" applies.]
[Rule "can't go through undescribed doors rule" applies.]
[Rule "can't go through closed doors rule" applies.]
(first opening Sainsburys Entrance door)
[Rule "announce items from multiple object lists rule" applies.]
[Rule "set pronouns from items from multiple object lists rule" applies.]
[Rule "before stage rule" applies.]
[Rule "instead stage rule" applies.]
[Rule "Instead of opening doors" applies.]
You can't do that! You're a turkey!

[Rule "A first turn sequence rule" applies.]
[Rule "every turn stage rule" applies.]
[Rule "A last turn sequence rule" applies.]
[Rule "notify score changes rule" applies.]

* * *

>n
Turkey Street Station
A bang. A yelp. A corpse. A chicken with a chalk outline, leaving behind a ghost with nobody to haunt.  The pancaked poultry beckons from within the cordon. I'll have to do the haunting for it. 

All roads lead back to the scene of the crime. Futility, or just fatality? There's a metaphor here, if one cares to explore it. And also a station entrance. A lonely lamppost stands across the street near a Nando's, like a lighthouse for a shipwrecked life.

You can see a dead chicken, a cardboard box with a hole in it, a crow and an Eagle here.

>n
The doors to the station are shut fast behind you, and because you are a turkey, they might as well be shut forever. You can't go that way.

>s
The doors to the station are shut fast behind you, and because you are a turkey, they might as well be shut forever. You can't go that way.

>w
Turkey Street West
A cardinal direction. A cardinal sin. My corpse has taken another spin on the karmic wheel, helped along by some mundane ones. There's no justice on these streets. There's just us. 

The West End is known for two things. Good plays, and bad turns. Which explains the unfolding supermarket turf war. The cordon of turkeys is a recent addition.

Herons like to feast on small prey. This one has a lean, hungry look to it. It knows something.

A winged killer, a seductive bird of prey. Once its yellow eye falls on you, it's already too late. Did it fall on the chicken?

You can also see a bus stop and a garbage bin here.

>n
The doors are shut fast, and because you are a turkey, they might as well be shut forever. You can't go that way.

* * *

>n
Turkey Street Station
A bang. A yelp. A corpse. A chicken with a chalk outline, leaving behind a ghost with nobody to haunt.  The pancaked poultry beckons from within the cordon. I'll have to do the haunting for it. 

All roads lead back to the scene of the crime. Futility, or just fatality? There's a metaphor here, if one cares to explore it. And also a station entrance. A lonely lamppost stands across the street near a Nando's, like a lighthouse for a shipwrecked life.

You can see a dead chicken, a cardboard box with a hole in it, a crow and an Eagle here.

>open box
Try as you might, neither your feathers or your intellect will allow you to open this box. It's sealed tight.

>eat box
That's plainly inedible.

* * *

>n
Turkey Street Station
A bang. A yelp. A corpse. A chicken with a chalk outline, leaving behind a ghost with nobody to haunt.  The pancaked poultry beckons from within the cordon. I'll have to do the haunting for it. 

All roads lead back to the scene of the crime. Futility, or just fatality? There's a metaphor here, if one cares to explore it. And also a station entrance. A lonely lamppost stands across the street near a Nando's, like a lighthouse for a shipwrecked life.

You can see a dead chicken, a cardboard box with a hole in it, a crow and an Eagle here.

>r
That's not a verb I recognise.

>e
Turkey Street East
People have always looked to the East for their panaceas. But Turkey Street is sick, rotten to the core. I can't cure what ails it--I can only burn it out. 

There's an edge to the air in East End, an edge I live on. And so does an ornithophobic child cowering in fear from the spectre of a gluttonous duck feasting on bits of bread strewn everywhere. For now, a cordon of turkeys joins me on the edge.

You can see a child and a duck here.

* * *

>n
Turkey Street Station
A bang. A yelp. A corpse. A chicken with a chalk outline, leaving behind a ghost with nobody to haunt.  The pancaked poultry beckons from within the cordon. I'll have to do the haunting for it. 

All roads lead back to the scene of the crime. Futility, or just fatality? There's a metaphor here, if one cares to explore it. And also a station entrance. A lonely lamppost stands across the street near a Nando's, like a lighthouse for a shipwrecked life.

You can see a dead chicken, a cardboard box with a hole in it, a crow and an Eagle here.

>rules
Rules tracing now switched on. Type "rules off" to switch it off again, or "rules all" to include even rules which do not apply.

>gobble crow
[Rule "declare everything initially unmentioned rule" applies.]
[Rule "announce items from multiple object lists rule" applies.]
[Rule "set pronouns from items from multiple object lists rule" applies.]
[Rule "before stage rule" applies.]
[Rule "instead stage rule" applies.]
[Rule "instead of gobbling the crow" applies.]
"Gobble, gobble." "Ca-kaw! Ca'kaw caKAW" Chattering away like a thief in the night.

[Rule "A first turn sequence rule" applies.]
[Rule "every turn stage rule" applies.]
[Rule "Every turn" applies.]
[Rule "A last turn sequence rule" applies.]
[Rule "notify score changes rule" applies.]

* * *

>x crow
[Rule "declare everything initially unmentioned rule" applies.]
[Rule "announce items from multiple object lists rule" applies.]
[Rule "set pronouns from items from multiple object lists rule" applies.]
[Rule "before stage rule" applies.]
[Rule "can't act in the dark rule" applies.]
[Rule "instead stage rule" applies.]
[Rule "Instead of examining the crow when the locket is lost" applies.]
Upon closer examination, the crow appears to have a locket hanging from it's neck. Maybe you could scare the crow into dropping it somehow
[Rule "A first turn sequence rule" applies.]
[Rule "every turn stage rule" applies.]
[Rule "Every turn" applies.]
[Rule "A last turn sequence rule" applies.]
[Rule "notify score changes rule" applies.]

* * *

>gobble crow
[Rule "declare everything initially unmentioned rule" applies.]
[Rule "announce items from multiple object lists rule" applies.]
[Rule "set pronouns from items from multiple object lists rule" applies.]
[Rule "before stage rule" applies.]
[Rule "instead stage rule" applies.]
[Rule "Instead of gobbling the crow when the locket is found" applies.]
You stare down the crow. It stares back at you. Time slows down. Eternity passes. "Gobble. GOBBLE." 

 "Ca-kaw! Ca'kaw caKAW" The crow screeches and drops the locket just out of reach. You should take it to examine it elsewhere before it snatches it back!

[Rule "A first turn sequence rule" applies.]
[Rule "every turn stage rule" applies.]

*** Run-time problem P10: Since the field mouse is not allowed the property "evidence condition", it is against the rules to try to use it.

[Rule "Every turn" applies.]
[Rule "A last turn sequence rule" applies.]
[Rule "notify score changes rule" applies.]

* * *

>n
Turkey Street Station
A bang. A yelp. A corpse. A chicken with a chalk outline, leaving behind a ghost with nobody to haunt.  The pancaked poultry beckons from within the cordon. I'll have to do the haunting for it. 

All roads lead back to the scene of the crime. Futility, or just fatality? There's a metaphor here, if one cares to explore it. And also a station entrance. A lonely lamppost stands across the street near a Nando's, like a lighthouse for a shipwrecked life.

You can see a dead chicken, a cardboard box with a hole in it, a crow and an Eagle here.

>s
The doors to the station are shut fast behind you, and because you are a turkey, they might as well be shut forever. You can't go that way.

>n
The doors to the shops are shut fast, and because you are a turkey, they might as well be shut forever. You can't go that way.

>w
Turkey Street West
A cardinal direction. A cardinal sin. My corpse has taken another spin on the karmic wheel, helped along by some mundane ones. There's no justice on these streets. There's just us. 

The West End is known for two things. Good plays, and bad turns. Which explains the unfolding supermarket turf war. The cordon of turkeys is a recent addition.

Herons like to feast on small prey. This one has a lean, hungry look to it. It knows something.

A winged killer, a seductive bird of prey. Once its yellow eye falls on you, it's already too late. Did it fall on the chicken?

You can also see a bus stop and a garbage bin here.

>n
The doors to the shops are shut fast, and because you are a turkey, they might as well be shut forever. You can't go that way.

* * *

>n
Turkey Street Station
A bang. A yelp. A corpse. A chicken with a chalk outline, leaving behind a ghost with nobody to haunt.  The pancaked poultry beckons from within the cordon. I'll have to do the haunting for it. 

All roads lead back to the scene of the crime. Futility, or just fatality? There's a metaphor here, if one cares to explore it. And also a station entrance. A lonely lamppost stands across the street near a Nando's, like a lighthouse for a shipwrecked life.

You can see a dead chicken, a cardboard box with a hole in it, a crow and an Eagle here.

>w
Turkey Street West
A cardinal direction. A cardinal sin. My corpse has taken another spin on the karmic wheel, helped along by some mundane ones. There's no justice on these streets. There's just us. 

The West End is known for two things. Good plays, and bad turns. Which explains the unfolding supermarket turf war. The cordon of turkeys is a recent addition.

Herons like to feast on small prey. This one has a lean, hungry look to it. It knows something.

A winged killer, a seductive bird of prey. Once its yellow eye falls on you, it's already too late. Did it fall on the chicken?

You can also see a bus stop and a garbage bin here.

>clear
What do you want to clear?

>clear screen
You can't see any such thing.

>help
That's not a verb I recognise.

>HELP
That's not a verb I recognise.

>HELP
That's not a verb I recognise.

>COMMANDS
That's not a verb I recognise.

>COMMANDS
That's not a verb I recognise.

>command
That's not a verb I recognise.

>commands
That's not a verb I recognise.

>help
That's not a verb I recognise.

>UNDO
Turkey Street West
[Previous turn undone.]

* * *

>e
Turkey Street Station
All roads lead back to the scene of the crime. Futility, or just fatality? There's a metaphor here, if one cares to explore it. And also a station entrance.

A very dead chicken lies in the center of the road

Glorious, majestic, and free in all the ways that I am not. I already hate this bird. The feeling is probably mutual.

You can also see a crow here.

>e
Turkey Street East
People have always looked to the East for their panaceas. But Turkey Street is sick, rotten to the core. I can't cure what ails it--I can only burn it out. 

There's an edge to the air in East End, an edge I live on. And so do OBJECT and OBJECT2. For now, a cordon of turkeys joins me on the edge.

Dark of wing and dull of bill. The duck stands in a field, and wears no pants. It appears hungry. Hungry for the truth? Or for more murder?

You can also see a child here.

>z
Time passes.

>look
Turkey Street East
There's an edge to the air in East End, an edge I live on. And so do OBJECT and OBJECT2. For now, a cordon of turkeys joins me on the edge.

Dark of wing and dull of bill. The duck stands in a field, and wears no pants. It appears hungry. Hungry for the truth? Or for more murder?

You can also see a child here.

* * *

>e
Turkey Street Station
All roads lead back to the scene of the crime. Futility, or just fatality? There's a metaphor here, if one cares to explore it. And also a station entrance.

A very dead chicken lies in the center of the road

Glorious, majestic, and free in all the ways that I am not. I already hate this bird. The feeling is probably mutual.

You can also see a crow here.

>w
Turkey Street West
The West End is known for two things. Good plays, and bad turns. Which explains the unfolding supermarket turf war. The cordon of turkeys is a recent addition.

Herons like to feast on small prey. This one has a lean, hungry look to it. It knows something.

A winged killer, a seductive bird of prey. Once its yellow eye falls on you, it's already too late. Did it fall on the chicken?

You can also see a bus stop (on which is a red herring) and a garbage bin (closed) here.

>e
Turkey Street Station
DESCRIPTION

>e
Turkey Street East
DESCRIPTION EAST

>w
Turkey Street Station
DESCRIPTION

* * *

>look
Turkey Street West
The West End is known for two things. Good plays, and bad turns. Which explains the unfolding supermarket turf war. The cordon of turkeys is a recent addition.

A winged killer, a seductive bird of prey. Once its yellow eye falls on you, it's already too late. Did it fall on the chicken?

You can also see a bus stop (on which is a red herring), a garbage bin (closed) and a heron here.

* * *

>n
The doors are shut fast, and because you are a turkey, they might as well be shut forever. You can't go that way.

>look
Turkey Street West
DESCRIPTION WEST

* * *

>n
The doors are shut fast, and because you are a turkey, they might as well be shut forever. You can't go that way.

>rules
Rules tracing now switched on. Type "rules off" to switch it off again, or "rules all" to include even rules which do not apply.

>n
[Rule "declare everything initially unmentioned rule" applies.]
[Rule "standard set going variables rule" applies.]
[Rule "announce items from multiple object lists rule" applies.]
[Rule "set pronouns from items from multiple object lists rule" applies.]
[Rule "before stage rule" applies.]
[Rule "instead stage rule" applies.]
[Rule "investigate player's awareness before action rule" applies.]
[Rule "player aware of his own actions rule" applies.]
[Rule "check stage rule" applies.]
[Rule "can't travel in what's not a vehicle rule" applies.]
[Rule "can't go through undescribed doors rule" applies.]
[Rule "can't go through closed doors rule" applies.]
[Rule "determine map connection rule" applies.]
[Rule "can't go that way rule" applies.]
You can't, since Sainsburys Entrance door leads nowhere.

[Rule "A first turn sequence rule" applies.]
[Rule "every turn stage rule" applies.]
[Rule "A last turn sequence rule" applies.]
[Rule "notify score changes rule" applies.]

* * *

>n
The doors are shut fast, and because you are a turkey, they might as well be shut forever. You can't go that way.

>s
The doors are shut fast, and because you are a turkey, they might as well be shut forever. You can't go that way.

* * *

>n
The doors are shut fast, and because you are a turkey, they might as well be shut forever. You can't go that way.

>x door
Which do you mean, Sainsburys Entrance door or Tesco Entrance door?

>x sainsburys entrance door
You see nothing special about Sainsburys Entrance door.

>close door
Which do you mean, Sainsburys Entrance door or Tesco Entrance door?

>close sainsbury door
You can't do that! You're a turkey!

* * *

>w
The road is blocked by Turkeys!

>n
The doors are shut fast, and because you are a turkey, they might as well be shut forever. You can't go that way.

* * *

>rules
Rules tracing now switched on. Type "rules off" to switch it off again, or "rules all" to include even rules which do not apply.

>n
[Rule "declare everything initially unmentioned rule" applies.]
[Rule "standard set going variables rule" applies.]
[Rule "announce items from multiple object lists rule" applies.]
[Rule "set pronouns from items from multiple object lists rule" applies.]
[Rule "before stage rule" applies.]
[Rule "instead stage rule" applies.]
[Rule "Instead of going nowhere from Turkey Street West" applies.]
The doors are shut fast, and because you are a turkey, they might as well be shut forever. You can't go that way.

[Rule "A first turn sequence rule" applies.]
[Rule "every turn stage rule" applies.]
[Rule "A last turn sequence rule" applies.]
[Rule "notify score changes rule" applies.]

* * *

>w
The road is blocked by Turkeys!

>w
The road is blocked by Turkeys!

>e
Turkey Street Station
DESCRIPTION

* * *

>w
Turkey Street Station
DESCRIPTION

>w
Turkey Street West
DESCRIPTION WEST

>w
The road is blocked by Turkeys!

* * *

>s
The doors are shut fast, and because you are a turkey, they might as well be shut forever. You can't go that way.

>e
Turkey Street Station
DESCRIPTION

* * *

>w
The road is blocked by Turkeys!

>rules
Rules tracing now switched on. Type "rules off" to switch it off again, or "rules all" to include even rules which do not apply.

>w
[Rule "declare everything initially unmentioned rule" applies.]
[Rule "standard set going variables rule" applies.]
[Rule "announce items from multiple object lists rule" applies.]
[Rule "set pronouns from items from multiple object lists rule" applies.]
[Rule "before stage rule" applies.]
[Rule "instead stage rule" applies.]
[Rule "investigate player's awareness before action rule" applies.]
[Rule "player aware of his own actions rule" applies.]
[Rule "check stage rule" applies.]
[Rule "can't travel in what's not a vehicle rule" applies.]
[Rule "can't go through undescribed doors rule" applies.]
[Rule "can't go through closed doors rule" applies.]
[Rule "determine map connection rule" applies.]
[Rule "can't go that way rule" applies.]
You can't go that way.

[Rule "A first turn sequence rule" applies.]
[Rule "every turn stage rule" applies.]
[Rule "A last turn sequence rule" applies.]
[Rule "notify score changes rule" applies.]

* * *

>x bin
This garbage bin is utterly filthy, like your sense of humor. In the depths of this filth (within the bin, not yourself) lies ... THE MURDER WEAPON.

>x bin
In the garbage bin is a murder weapon.

>take murder weapon
That is far too big for you to carry in your beak and you don't want to ruffle your feathers! You can not take it with you.

>x murder weapon
You see nothing special about the murder weapon.

[Your score has just gone up by ten points.]

* * *

>x bus stop
The bus stop appears to be in a state of disrepair. One side is slumped over and is low enough for you to climb on top of it.

On the bus stop is a red herring.

>get on bus stop
You get onto the bus stop.

On the bus stop you can see a red herring.

* * *

>n
Turkey Street Station
A bang. A yelp. A corpse. A chicken with a chalk outline, leaving behind a ghost with nobody to haunt.  The pancaked poultry beckons from within the cordon. I'll have to do the haunting for it. 

All roads lead back to the scene of the crime. Futility, or just fatality? There's a metaphor here, if one cares to explore it. And also a station entrance. A lonely lamppost stands across the street near a Nando's, like a lighthouse for a shipwrecked life.

You can see a dead chicken, a cardboard box with a hole in it, a crow and an Eagle here.

>x Nando's
You see nothing special about the Nando's.

* * *

>n
Turkey Street Station
A bang. A yelp. A corpse. A chicken with a chalk outline, leaving behind a ghost with nobody to haunt.  The pancaked poultry beckons from within the cordon. I'll have to do the haunting for it. 

All roads lead back to the scene of the crime. Futility, or just fatality? There's a metaphor here, if one cares to explore it. And also a station entrance. A lonely lamppost stands across the street near a Nando's, like a lighthouse for a shipwrecked life.

You can see a dead chicken, a cardboard box with a hole in it, a crow and an Eagle here.

>x box
YAY

* * *

>n
Turkey Street Station
A bang. A yelp. A corpse. A chicken with a chalk outline, leaving behind a ghost with nobody to haunt.  The pancaked poultry beckons from within the cordon. I'll have to do the haunting for it. 

All roads lead back to the scene of the crime. Futility, or just fatality? There's a metaphor here, if one cares to explore it. And also a station entrance. A lonely lamppost stands across the street near a Nando's, like a lighthouse for a shipwrecked life.

You can see a dead chicken, a cardboard box with a hole in it, a crow and an Eagle here.

>x chicken
This chicken is quite dead. Tire-tracks run down its spine and through its spilled guts. Still clutched in its beak, a letter!

* * *

>look
Turkey Street Station
All roads lead back to the scene of the crime. Futility, or just fatality? There's a metaphor here, if one cares to explore it. And also a station entrance. A lonely lamppost stands across the street near a Nando's, like a lighthouse for a shipwrecked life.

You can see a letter, a dead chicken, a cardboard box with a hole in it, a crow and an Eagle here.

>x chicken
You see nothing special about the dead chicken.

* * *

>x letter
Is this... an ode to farts? Whatever it is, it's personal, sappy, and somewhat disgusting.

[Your score has just gone up by ten points.]

>look
Turkey Street Station
All roads lead back to the scene of the crime. Futility, or just fatality? There's a metaphor here, if one cares to explore it. And also a station entrance. A lonely lamppost stands across the street near a Nando's, like a lighthouse for a shipwrecked life.

You can see a  (examined), a dead chicken, a cardboard box with a hole in it, a crow and an Eagle here.

* * *

>x chicken
This chicken is quite dead. Tire-tracks run down its spine and through its spilled guts. Still clutched in its beak, a letter!

>x letter
Is this... an ode to farts? Whatever it is, it's personal, sappy, and somewhat disgusting.

[Your score has just gone up by ten points.]

>look
Turkey Street Station
All roads lead back to the scene of the crime. Futility, or just fatality? There's a metaphor here, if one cares to explore it. And also a station entrance. A lonely lamppost stands across the street near a Nando's, like a lighthouse for a shipwrecked life.

You can see a nothing (examined), a dead chicken, a cardboard box with a hole in it, a crow and an Eagle here.

* * *

>x crow
Upon closer examination, the crow appears to have a locket hanging from it's neck. Maybe you could scare the crow into dropping it somehow

>gobble at crow
You stare down the crow menacingly. It stares back at you. Time slows down. Eternity passes. "Gobble. GOBBLE." 

 "Ca-kaw! Ca'kaw caKAW" The crow screeches in fear, and drops the locket just out of reach. You should take it to examine it elsewhere before it snatches it back!

>look
Turkey Street Station
All roads lead back to the scene of the crime. Futility, or just fatality? There's a metaphor here, if one cares to explore it. And also a station entrance. A lonely lamppost stands across the street, like a lighthouse for a shipwrecked life.

You can see a locket, a dead chicken, a crow and an eagle here.

>take locket
Taken.

>e
Turkey Street East
People have always looked to the East for their panaceas. But Turkey Street is sick, rotten to the core. I can't cure what ails it--I can only burn it out. 

There's an edge to the air in East End, an edge I live on. And so does an ornithophobic child cowering in fear from the spectre of a gluttonous duck feasting on bits of bread strewn everywhere. For now, a cordon of turkeys joins me on the edge.

You can see a child and a duck here.

>x locket
A small, heart-shaped locket. No inscription. Just a chicken... and a chick.

[Your score has just gone up by ten points.]

* * *

>x crow
Upon closer examination, the crow appears to have a locket hanging from it's neck. Maybe you could scare the crow into dropping it somehow

>gobble crow
You stare down the crow. It stares back at you. Time slows down. Eternity passes. "Gobble. GOBBLE." 

 "Ca-kaw! Ca'kaw caKAW" The crow screeches and drops the locket just out of reach. You should take it to examine it elsewhere before it snatches it back!

Your standoff with the crow has terrified the mouse. It no longer feels safe inside it's cardboard box and is escaping for freedom with the shiny thing. Catch it!

>catch mouse
That's not a verb I recognise.

>take mouse
That is far too big for you to carry in your beak and you don't want to ruffle your feathers! You can not take it with you.

>take ring
You can't see any such thing.

* * *

>gobble crow
You stare down the crow. It stares back at you. Time slows down. Eternity passes. "Gobble. GOBBLE." 

 "Ca-kaw! Ca'kaw caKAW" The crow screeches and drops the locket just out of reach. You should take it to examine it elsewhere before it snatches it back!

Your standoff with the crow has terrified the mouse. It no longer feels safe inside it's cardboard box and is escaping for freedom with the shiny thing. Catch it!

>take ring
The mouse is far to quick for you to catch

>z
Time passes.

>z
Time passes.

Death swoops in from above and in a flash of beak and squeak, the mouse is gone. The eagle returns to his perch, leaving the shiny ring on the ground.

>look
Turkey Street Station
All roads lead back to the scene of the crime. Futility, or just fatality? There's a metaphor here, if one cares to explore it. And also a station entrance. A lonely lamppost stands across the street near a Nando's, like a lighthouse for a shipwrecked life.

You can see a ring, a locket, a dead chicken, a cardboard box with a hole in it, a crow and an Eagle here.

>examine ring
A small, shiny bauble. A white elephant.

[Your score has just gone up by ten points.]

* * *

>x crow
Upon closer examination, the crow appears to have a locket hanging from it's neck. Maybe you could scare the crow into dropping it somehow

>x crow
You see nothing special about the crow.

>x eagle
You see nothing special about the eagle.

* * *

>n
Turkey Street Station
A bang. A yelp. A corpse. A chicken with a chalk outline, leaving behind a ghost with nobody to haunt.  The pancaked poultry beckons from within the cordon. I'll have to do the haunting for it. 

All roads lead back to the scene of the crime. Futility, or just fatality? There's a metaphor here, if one cares to explore it. And also a station entrance. A lonely lamppost stands across the street near a Nando's, like a lighthouse for a shipwrecked life.

You can see a dead chicken, a cardboard box with a hole in it, a crow and an Eagle here.

>x lamppost
You can't see any such thing.

>x crow
Upon closer examination, the crow appears to have a locket hanging from it's neck. Maybe you could scare the crow into dropping it somehow

>x crow
A pair of beady eyes stares at you. Crows. Scavengers, the murderous lot of them. I'd watch my belongings around them, if I could carry any. YAY.

* * *

>n
Turkey Street Station
A bang. A yelp. A corpse. A chicken with a chalk outline, leaving behind a ghost with nobody to haunt.  The pancaked poultry beckons from within the cordon. I'll have to do the haunting for it. 

All roads lead back to the scene of the crime. Futility, or just fatality? There's a metaphor here, if one cares to explore it. And also a station entrance. A lonely lamppost stands across the street near a Nando's, like a lighthouse for a shipwrecked life.

You can see a dead chicken, a cardboard box with a hole in it, a crow and an Eagle here.

>x mouse
You can't see any such thing.

* * *

>n
Turkey Street Station
A bang. A yelp. A corpse. A chicken with a chalk outline, leaving behind a ghost with nobody to haunt.  The pancaked poultry beckons from within the cordon. I'll have to do the haunting for it. 

All roads lead back to the scene of the crime. Futility, or just fatality? There's a metaphor here, if one cares to explore it. And also a station entrance. A lonely lamppost stands across the street near a Nando's, like a lighthouse for a shipwrecked life.

You can see a dead chicken, a cardboard box with a hole in it, a crow and an Eagle here.

>x nandos
You can't see any such thing.

>x nando's
THE HORROR!

* * *

>n
On the Case
The chick's distress is still fresh and palpable. She can't help me now. I leave her to her clucking. With some luck, she'll still be there when I come home to roost. I spread my wings and glide away to the next case. A case more interesting than the typical cuckolding of henpecked husbands I get saddled with. The case of... WHY THE CHICKEN CROSSED THE ROAD. 

This road continues north ... to Turkey Street.

>s
You can't go that way.

>n
Turkey Street Station
A bang. A yelp. A corpse. A chicken with a chalk outline, leaving behind a ghost with nobody to haunt.  The pancaked poultry beckons from within the cordon. I'll have to do the haunting for it. 

All roads lead back to the scene of the crime. Futility, or just fatality? There's a metaphor here, if one cares to explore it. And also a station entrance. A lonely lamppost stands across the street, like a lighthouse for a shipwrecked life.

A very dead chicken lies in the center of the road

Crows. Scavengers, the murderous lot of them. I'd watch my belongings around them, if I could carry any.

Glorious, majestic, and free in all the ways that I am not. I already hate this bird. The feeling is probably mutual.

>s
You can't, since Station Entrance leads nowhere.

>go south
You can't, since Station Entrance leads nowhere.

* * *

>observe
(the child)
You see nothing special about the child.

>look at
(the child)
You see nothing special about the child.

>look
The Roost
The roost smells faintly of sawdust, old eggs, and bourbon. The half-drunk bottle explains the half-drunk turkey. A chick is pacing back and forth, occasionally stopping to peck at itself.

You can see a child here.

>gobble child
GOBBLE GOBBLE GOBBLE!
The child runs screaming, and appears to have dropped something

* * *

>UNDO
The Roost
[Previous turn undone.]

>UNDO
The Roost
[Previous turn undone.]

>look
The Roost
The roost smells faintly of sawdust, old eggs, and bourbon. The half-drunk bottle explains the half-drunk turkey. A chick is pacing back and forth, occasionally stopping to peck at itself.

You can see a child here.

>gobble at the child
GOBBLE GOBBLE GOBBLE!
The child runs screaming, and appears to have dropped something

* * *

>open bottle
It isn't something you can open.

>x bottle
You see nothing special about the bottle.

>look
The Roost
The roost smells faintly of sawdust, old eggs, and bourbon. The half-drunk bottle explains the half-drunk turkey. A chick is pacing back and forth, occasionally stopping to peck at itself.

* * *

>open door
You can't do that! You're a turkey!

>close door
That's already closed.

* * *

>rules
Rules tracing now switched on. Type "rules off" to switch it off again, or "rules all" to include even rules which do not apply.

>rulesn
That's not a verb I recognise.

>n
[Rule "declare everything initially unmentioned rule" applies.]
[Rule "standard set going variables rule" applies.]
[Rule "announce items from multiple object lists rule" applies.]
[Rule "set pronouns from items from multiple object lists rule" applies.]
[Rule "before stage rule" applies.]
[Rule "instead stage rule" applies.]
[Rule "investigate player's awareness before action rule" applies.]
[Rule "player aware of his own actions rule" applies.]
[Rule "check stage rule" applies.]
[Rule "can't travel in what's not a vehicle rule" applies.]
[Rule "can't go through undescribed doors rule" applies.]
[Rule "can't go through closed doors rule" applies.]
[Rule "determine map connection rule" applies.]
[Rule "can't go that way rule" applies.]
[Rule "carry out stage rule" applies.]
[Rule "move player and vehicle rule" applies.]
[Rule "move floating objects rule" applies.]
[Rule "check light in new location rule" applies.]
[Rule "after stage rule" applies.]
[Rule "investigate player's awareness after action rule" applies.]
[Rule "report stage rule" applies.]
[Rule "describe room gone into rule" applies.]

[Rule "determine visibility ceiling rule" applies.]
[Rule "investigate player's awareness before action rule" applies.]
[Rule "player aware of his own actions rule" applies.]
[Rule "check stage rule" applies.]
[Rule "carry out stage rule" applies.]
[Rule "declare everything unmentioned rule" applies.]
[Rule "room description heading rule" applies.]
On the Case
[Rule "room description body text rule" applies.]
DESCRIPTION

[Rule "room description paragraphs about objects rule" applies.]
[Rule "initialise locale description rule" applies.]
[Rule "find notable locale objects rule" applies.]
[Rule "standard notable locale objects rule" applies.]
[Rule "interesting locale paragraphs rule" applies.]
[Rule "don't mention player's supporter in room descriptions rule" applies.]
[Rule "don't mention scenery in room descriptions rule" applies.]
[Rule "don't mention undescribed items in room descriptions rule" applies.]
[Rule "set pronouns from items in room descriptions rule" applies.]
[Rule "offer items to writing a paragraph about rule" applies.]
[Rule "use initial appearance in room descriptions rule" applies.]
[Rule "describe what's on scenery supporters in room descriptions rule" applies.]
[Rule "describe what's on mentioned supporters in room descriptions rule" applies.]
[Rule "you-can-also-see rule" applies.]
[Rule "check new arrival rule" applies.]
[Rule "first time looking rule" applies.]
[Rule "after stage rule" applies.]
[Rule "investigate player's awareness after action rule" applies.]
[Rule "report stage rule" applies.]
[Rule "other people looking rule" applies.]
[Rule "last specific action-processing rule" applies.]
[Rule "last specific action-processing rule" applies.]
[Rule "A first turn sequence rule" applies.]
[Rule "every turn stage rule" applies.]
[Rule "A last turn sequence rule" applies.]
[Rule "notify score changes rule" applies.]

I beg your pardon?

* * *

>q
[Rule "declare everything initially unmentioned rule" applies.]
[Rule "investigate player's awareness before action rule" applies.]
[Rule "player aware of his own actions rule" applies.]
[Rule "check stage rule" applies.]
[Rule "carry out stage rule" applies.]
Are you sure you want to quit?

* * *

>s
You can't go that way.

>n
On the Case
The chick's distress is still fresh and palpable. She can't help me now. I leave her to her clucking. With some luck, she'll still be there when I come home to roost. I spread my wings and glide away to the next case. A case more interesting than the typical cuckolding of henpecked husbands I get saddled with. The case of... WHY THE CHICKEN CROSSED THE ROAD.

>s
You can't go that way.

* * *

Turkey Street
                                                                        by Raymond Vermeulen and Matthew Deline

Welcome to Turkey Street! You are about to embark upon a gritty and super serious parser adventure where you play as a turkey detective. Before you start, please be aware that some of the commands may be different from other games that you have played in the past.

Commands are limited to directional travel (N, S, E, W), LOOK, EXAMINE (or X), GIVE, TAKE, DROP, WAIT, EAT, DRINK, and GOBBLE or GOBBLE AT (which refers to turkey speak, not the action of eating). You can also type COMMANDS to see this list again, UNDO to go back a turn, or SAVE to record your progress. Have fun!

   Start the story - from the beginning    :    (SPACE)
                   - from a saved position :       R
   Quit                                    :       Q

Turkey Street
An Interactive Fiction by Raymond Vermeulen and Matthew Deline
Release 1 / Serial number 180502 / Inform 7 build 6M62 (I6/v6.33 lib 6/12N) SD

The Roost
Back at the roost, there's two wild turkeys. One's a bottle and it's perfectly aged, one's a P.I. and it's aged perfectly. The name's Fowl Feathers. Uncompromising since 2015. In my line of work, you meet a lot of birds. And the birds always like a bad egg. 

The roost smells faintly of sawdust, old eggs, and bourbon. The half-drunk bottle explains the half-drunk turkey. A chick is pacing back and forth, occasionally stopping to peck at itself.

You can see a sign here.

>look
The Roost
The roost smells faintly of sawdust, old eggs, and bourbon. The half-drunk bottle explains the half-drunk turkey. A chick is pacing back and forth, occasionally stopping to peck at itself.

You can see a sign here.

>look at chick
Young, blonde, and clearly stressed out. She smells like danger, a danger on which I will have to whet my beak.

>cluck
That's not a verb I recognise.

>gobble
What do you want to gobble?

>gobble at chick
"Cluck. Cluck. Cluck cluck CLUCK-AH." She sings her sweet song to me.

>n
On the Case
The chick's distress is still fresh and palpable. She can't help me now. I leave her to her clucking. With some luck, she'll still be there when I come home to roost. I spread my wings and glide away to the next case. A case more interesting than the typical cuckolding of henpecked husbands I get saddled with. The case of... WHY THE CHICKEN CROSSED THE ROAD.

>n
Turkey Street Station
A bang. A yelp. A corpse. A chicken with a chalk outline, leaving behind a ghost with nobody to haunt.  The pancaked poultry beckons from within the cordon. I'll have to do the haunting for it. 

A very dead chicken lies in the center of the road

You can also see a fox and an eagle here.

>l
Turkey Street Station
All roads lead back to the scene of the crime. Futility, or just fatality? There's a metaphor here, if one cares to explore it. And also a station entrance. 

A very dead chicken lies in the center of the road

You can also see a fox and an eagle here.

>w
Turkey Street West
A cardinal direction. A cardinal sin. My corpse has taken another spin on the karmic wheel, helped along by some mundane ones. There's no justice on these streets. There's just us. 

You can see a bus stop (on which is a red herring), a heron and a duck here.

>l
Turkey Street West
The West End is known for two things. Good plays, and bad turns. Which explains the unfolding supermarket turf war. The cordon of turkeys is a recent addition. 

You can see a bus stop (on which is a red herring), a heron and a duck here.

>look at bus stop
The bus stop appears to be in a state of disrepair. One side is slumped over and is low enough for you to climb on top of it.

On the bus stop is a red herring.

>climb on bus stop
You can't see any such thing.

>take red herring
The herring appears to be just out of reach. You may not be able to fly, but there's more than one way to pluck a chicken. Maybe there is another way to get up there?

>fly up bus stop
That's not a verb I recognise.

>fly at
That's not a verb I recognise.

>fly
That's not a verb I recognise.

>jump
You jump on the spot.

>jump on bus stop
I only understood you as far as wanting to jump.

>just on
That's not a verb I recognise.

>jump
You jump on the spot.

>jump
You jump on the spot.

>climb bus stop
Little is to be achieved by that.

>look bus stop
The bus stop appears to be in a state of disrepair. One side is slumped over and is low enough for you to climb on top of it.

On the bus stop is a red herring.

>climb side
You can't see any such thing.

>go up
You get onto the bus stop.

On the bus stop you can see a red herring.

>eat red herring
I eat fishy business for breakfast, unfortunately I've already eaten lunch

>take red herring
Taken.

Drooling, the heron eyes you closely with an intense stare. Are these the eyes of a chicken chaser, or of hunger?

>gobble at heron
Drooling, the heron eyes you closely with an intense stare. Are these the eyes of a chicken chaser, or of hunger?

>gobble heron
Drooling, the heron eyes you closely with an intense stare. Are these the eyes of a chicken chaser, or of hunger?

>look at heron
You see nothing special about the heron.

Drooling, the heron eyes you closely with an intense stare. Are these the eyes of a chicken chaser, or of hunger?

>feed red herring to heron
The heron snaps the herring from your beak hungrily and flies away ungracefully. In the commotion, it drops a torn photograph

>take torn photograph
That is far too big for you to carry in your beak and you don't want to ruffle your feathers! You can not take it with you.

>look at photograph
You see nothing special about the torn photograph.

[Your score has just gone up by ten points.]

>reset
That's not a verb I recognise.

>reset
That's not a verb I recognise.

>stop
That's not a verb I recognise.

>reset
That's not a verb I recognise.

* * *

>save
Save failed.

* * *

>take bottle
The bottle is far too large to take with you. You're a turkey!

>drink bottle
There's nothing suitable to drink here.

>take sign
That's fixed in place.

>read sign
You see nothing special about the sign.

>x sign
You see nothing special about the sign.

* * *

>take egg
Taken.

>drop
(the egg)
Dropped.

>take spoon
That is far too big for you to carry in your beak and you don't want to ruffle your feathers! You can not take it with you.

* * *

>take egg
Taken.

>take spoon
Your inventory is full

* * *

>w
You can't go that way.

>x
What do you want to examine?

>look
Roost
The roost smells faintly of sawdust, old eggs, and bourbon. The half-drunk bottle explains the half-drunk turkey. A chick is pacing back and forth, occasionally stopping to peck at itself.

* * *

>x
(the child)
You see nothing special about the child.

>gobble child
GOBBLE GOBBLE GOBBLE!
The child runs screaming, and appears to have dropped something

>x
(the book)
You see nothing special about the book.

[Your score has just gone up by ten points.]

>z
Time passes.

* * *

>x
(the child)
You see nothing special about the child.

>w
You see nothing unexpected in that direction.

>look
Roost
The roost smells faintly of sawdust, old eggs, and bourbon. The half-drunk bottle explains the half-drunk turkey. A chick is pacing back and forth, occasionally stopping to peck at itself.

>look
Roost
The roost smells faintly of sawdust, old eggs, and bourbon. The half-drunk bottle explains the half-drunk turkey. A chick is pacing back and forth, occasionally stopping to peck at itself.

* * *

>x bottle
Wild Turkey, 101 proof. It's cheap, but it gets the job done. +101 proof.

>drink bottle
You have had enough... for now

>eat bottle
That's plainly inedible.

* * *

>x bottle
Wild Turkey, 101 proof. It's cheap, but it gets the job done. +101 proof.

>x bottle
 Wild Turkey, 101 proof. It's cheap, but it gets the job done

* * *

>x chick
Young, blonde, and clearly stressed out. She smells like danger, a danger on which I will have to whet my beak.

* * *

>x sign
A piece of wood lies against the entryway. It has been not so carefully pecked to read "Fowl Feathers, Poultry Investigator"

>look
The Roost
The roost smells faintly of sawdust, old eggs, and bourbon. The half-drunk bottle explains the half-drunk turkey. A chick is pacing back and forth, occasionally stopping to peck at itself.

You can see a sign here.